NO textures/w1.xpm
SO textures/w2.xpm
WE textures/w3.xpm
EA textures/w4.xpm

F 244,164,96
C 135,206,250

        1111111111111111111111111   11111
        1000000000110000000000001   1000111
        10110000011100000000000011111000001
        10010000000000000000000000000000001
1111111110110000011100000000000011111000001
100000000011000001111111111111111   1000001
11110011111111011100000010001       1000001
1111001111111101 101010010001       1000111
11000000110101011100000010001       11111
10000000000000000000000000W01
10000000000000001101010010001
1100000111010101111101101000111
11110111 1110101 101111010001
11111111 1111111 111111111111